111111111111111111111111111
100000011000000000000000001
100000000000000000000000001
100000000000000000000000P01
100000000000000000000000001
100000000000000000000000001
100000000000000000101100001
100000000000111101000000001
100000000000000000000000001
100000000000000000000000001
100000001000000000000000001
100000001000000000000000001
100000001000000000000000001
100000001000000000000000001
100000001000000000000000001
100000000000000000000000001
100000000000000000000000001
100000000000000000000000001
100000000000000000000000001
111111111111111111111111111