NO ./imgs/north.xpm
SO ./imgs/south.xpm
WE ./imgs/west.xpm
EA ./imgs/east.xpm
F 255,255,255
C 0,0,1

1111111111111111111111111
1000000000110000000000001
1011000001110000000000001
1001000000000000000000001111111111
1111111111011000001110000000000001
1000000000110000011101111111111111
11110111111111011100000010001
11110111111111011101010010001
11000000110101011100000010001
10000000000000001100000010001
10000000000000001101010010E01
1100000111010101111101111000011
11110111111010111011110100011
11111111111111111111111111111