11111111111111111111
10000000011000000001
10000000010101010101
10000000010101010101
10000000000000000001
10000000010101010101
10000000010101010101
10000000010101010101
10000000010101010101
10000000010101010101
10000000010101010101
10000000010101010101
10000000010101010101
10000000010101010101
10000000000000000001
1000P000010101010101
10000000010101010101
110E0C00111111111111
11111111111111111111