1111111111
1000000001
1P00000001
1000000001
1000000001
1000000101
1001000001
1000000001
100E0C0001
1111111111