1111111111
1000000E01
1000000001
1000000001
1000000001
1000000001
1000101001
1000000001
10000P0001
1111111111
1CCCCCCCE1
1111111111