NO ./imgs/north.xpm
SO ./imgs/south.xpm
WE ./imgs/west.xpm
EA ./imgs/east.xpm
F 220,100,0
C 225,30,0

1111111111111111111111111
100N000000110000000000001
1011000001110000000000001
1001000000000000000000001111111111
1111111111011000001110000000000001
1000000000110000011101111111111111
11110111111111011100000010001
11110111111111011101010010001
11000000110101011100000010001
10000000000000001100000010001
10000000000000001101010010001
1100000111010101111101111000111
1111011111101011101111010001
11111111111111111111111111111