1111111111
1000000001
1000000001
1000000001
1000000001
1000000101
1000000001
10P0000001
100E0C0001
1111111111